#Example: Large parts of Africa and south east Asia
tropical = {
}
arid = {
}
arctic = {
}
#Example: Most of Europe north of med.
mild_winter = {
}
#Example: Inland Europe & Scandinavia
normal_winter = {
}
#Example: Russia & Lappland
severe_winter = {
}
impassable = {
	75 115 126 132 145 158 264 551 548  552
	555 600 635  708
	204  775
	402 856  857
	867 869 870 871 873 874 875 876 877  878
	879 880 881 882 883 884 885 886 887  888
	889 890 891 892 893 894 895 896 897  898
	900 901 902 903 904 905 906 907 908  909
	910 911 912 913 914 915 916 917 918  919
	920 921 922 923 924 957 958  959
	925 926 927 928 929 930 931 932 933  934
	935 936 937 938 939 940 941 942 943  944
	945 946 947 948 949  950
	858 861 862 863 864 865 866 868  899
	605
	76 77 78 79 80 81 110 455 497  501
	588 589 590 591 592 593 594 595 596  597
	598 599 601 602 603 604 606 607 608  609
	610 611 612 613 614 615 617 618 619  620
	621 622 623 624 625 626 627 628 629  630
	631 632 633  634
	616 1207  1209
	119 202 205 467 527 774 782 783 784  785
	786 787 800 801 802 803 804 805 806  807
	808 809 810 814 830 831 832 833 834  835
	837 838 840 841 842 843 844 845 846  847
	848 849 850 851 852 853 854 855 952  953
	954 955 956 960 1154 1155 1156 1157 1158  1159
	1160 1161 1162 1163 1164 1165 1166 1167 1168  1169
	1170 1171 1172 1174  1175
	1173
	839 
}
mild_monsoon = {
	1 2 3 4 5 6 7 8 9  10
	11 12 13 14 15 16  85
}
normal_monsoon = {
}
severe_monsoon = {
}
equator_y_on_province_image = 656
